#,CLASS_METHOD,#INVOCATIONS,#COLLECTED,#UNIQUE,#TESTS,#PASSING,#FAILING,STATUS
1,PDSimpleFont_toUnicode,303441,69,63,63,63,0,well-tested
2,GlyfSimpleDescript_getFlags,120855,33298,15123,15123,15123,0,well-tested
3,HorizontalMetricsTable_getAdvanceWidth,86536,361,224,224,224,0,well-tested
4,RenderingMode_isFill,83362,83362,1,1,1,0,well-tested
5,TTFGlyph2D_getPathForCharacterCode,68539,67,61,61,0,61,pseudo-tested
6,TTFGlyph2D_getPathForGID,68539,67,61,61,0,61,pseudo-tested
7,HorizontalMetricsTable_getLeftSideBearing,27538,204,204,204,204,0,well-tested
8,TTFDataStream_readUnsignedByteArray,27530,585,401,401,401,0,well-tested
9,Type1Glyph2D_getPathForCharacterCode,14764,57,46,46,0,46,pseudo-tested
10,PDStructureElement_getPage,14625,11,11,11,0,11,pseudo-tested
11,DefaultResourceCache_getFont,8934,19,19,19,9,10,pseudo-tested
12,NamingTable_getName,4798,198,113,113,113,0,well-tested
13,PDSimpleFont_hasExplicitWidth,4193,158,113,113,113,0,well-tested
14,TrueTypeFont_getAdvanceWidth,4159,376,226,226,226,0,well-tested
15,PDTrueTypeFont_getPath,3071,51,51,51,0,51,pseudo-tested
16,PDCIDFontType2_codeToGID,3000,27,14,14,14,0,well-tested
17,PDFontDescriptor_getFlags,1190,265,136,136,136,0,well-tested
18,PDAnnotation_isHidden,1035,26,26,26,26,0,well-tested
19,PDAnnotation_getOptionalContent,798,30,24,24,24,0,pseudo-tested
20,PDType1CFont_getPath,570,36,36,36,0,36,pseudo-tested
21,FontCache_getFont,557,120,92,92,42,50,well-tested
22,COSParser_getEncryption,313,23,23,23,23,0,pseudo-tested
23,XrefTrailerResolver_getXrefType,312,288,180,180,180,0,well-tested
24,PDImageXObject_getDecode,291,34,22,22,22,0,pseudo-tested
25,PDCIDFontType2_getPath,284,26,26,26,0,26,pseudo-tested
26,DefaultResourceCache_getXObject,224,38,35,35,31,4,pseudo-tested
27,PDCIDSystemInfo_getOrdering,220,220,11,11,11,0,well-tested
28,PDType1Font_hasGlyph,220,146,137,137,137,0,well-tested
29,PDImageXObject_getInterpolate,178,33,33,33,33,0,well-tested
30,PDFontDescriptor_isSymbolic,168,93,52,52,52,0,well-tested
31,PDFormXObject_getOptionalContent,151,23,23,23,0,23,pseudo-tested
32,PDImageXObject_getColorKeyMask,129,23,23,23,23,0,pseudo-tested
33,PDStructureElement_getClassNames,117,14,14,14,0,14,pseudo-tested
34,PDImageXObject_getMask,105,23,23,23,23,0,pseudo-tested
35,PDFontDescriptor_getFontFile,99,99,45,45,12,33,pseudo-tested
36,PDImageXObject_getOptionalContent,89,27,27,27,27,0,pseudo-tested
37,PDResources_getExtGState,81,23,19,19,0,19,pseudo-tested
38,DefaultResourceCache_getExtGState,80,53,42,42,10,32,pseudo-tested
39,TrueTypeFont_getOS2Windows,65,65,17,17,6,11,pseudo-tested
40,PDCIDFont_getCIDSystemInfo,63,33,17,17,0,17,pseudo-tested
41,PDType1CFont_getBaseFont,62,48,42,42,42,0,well-tested
42,CIDType0Glyph2D_getPathForCharacterCode,60,34,34,34,0,34,pseudo-tested
43,COSDictionary_getBoolean,60,60,14,14,14,0,well-tested
44,PDCIDSystemInfo_getRegistry,59,59,12,12,12,0,well-tested
45,PDExtendedGraphicsState_getStrokingOverprintControl,52,52,6,6,6,0,well-tested
46,PDAnnotationWidget_getAppearanceCharacteristics,37,34,16,16,5,11,pseudo-tested
47,PDExtendedGraphicsState_getAutomaticStrokeAdjustment,35,35,7,7,7,0,well-tested
48,PDOptionalContentGroup_getRenderState,34,34,4,4,4,0,pseudo-tested
49,PDExtendedGraphicsState_getNonStrokingAlphaConstant,32,32,2,2,2,0,well-tested
50,PDDocumentCatalog_getMarkInfo,30,13,13,13,2,11,pseudo-tested
51,PDExtendedGraphicsState_getStrokingAlphaConstant,30,30,1,1,1,0,well-tested
52,PDMarkInfo_isSuspect,30,30,6,6,6,0,well-tested
53,PDMarkInfo_usesUserProperties,30,30,8,8,8,0,well-tested
54,PDOptionalContentMembershipDictionary_getVisibilityPolicy,30,30,1,1,1,0,well-tested
55,PDAnnotationWidget_getBorderStyle,29,28,26,26,17,9,pseudo-tested
56,PDExtendedGraphicsState_getOverprintMode,29,29,8,8,8,0,well-tested
57,PDCIDFontType0_getPath,28,28,28,28,0,28,pseudo-tested
58,PDCIDFontType0_hasGlyph,28,28,28,28,28,0,well-tested
59,PDDocumentCatalog_getLanguage,27,13,13,13,13,0,well-tested
60,PDExtendedGraphicsState_getNonStrokingOverprintControl,26,26,6,6,6,0,well-tested
61,PDExtendedGraphicsState_getSmoothnessTolerance,23,23,5,5,5,0,well-tested
62,DefaultResourceCache_getColorSpace,22,22,20,20,9,11,pseudo-tested
63,PDDocumentCatalog_getViewerPreferences,21,10,10,10,10,0,pseudo-tested
64,PDAnnotationLink_getBorderStyle,20,20,14,14,0,14,pseudo-tested
65,PDFontDescriptor_isFixedPitch,20,20,10,10,10,0,well-tested
66,PDFontDescriptor_isItalic,20,20,10,10,10,0,well-tested
67,PDFontDescriptor_isSerif,18,18,9,9,9,0,well-tested
68,PDField_getActions,16,16,16,16,16,0,pseudo-tested
69,RandomAccessFile_read,16,16,2,2,0,2,pseudo-tested
70,PDVariableText_getQ,15,15,15,15,15,0,well-tested
71,PDBorderStyleDictionary_getWidth,14,14,4,4,4,0,well-tested
72,PDInlineImage_getInterpolate,12,12,2,2,2,0,well-tested
73,PDAppearanceCharacteristicsDictionary_getBackground,10,10,2,2,2,0,pseudo-tested
74,PDAppearanceCharacteristicsDictionary_getBorderColour,10,10,2,2,1,1,pseudo-tested
75,PDInlineImage_getFilters,8,8,4,4,4,0,pseudo-tested
76,DefaultResourceCache_getProperties,6,6,5,5,5,0,pseudo-tested
77,PDICCBased_getDefaultDecode,6,6,3,3,3,0,well-tested
78,PDAnnotation_getColor,5,5,5,5,1,4,pseudo-tested
79,PDAnnotationLink_getQuadPoints,5,5,5,5,5,0,well-tested
80,PDAppearanceContentStream_setStrokingColorOnDemand,5,5,5,5,5,0,well-tested
81,FDFField_getClearFieldFlags,4,4,2,2,2,0,well-tested
82,FDFField_getClearWidgetFieldFlags,4,4,2,2,2,0,well-tested
83,FDFField_getFieldFlags,4,4,2,2,2,0,well-tested
84,FDFField_getKids,4,4,2,2,2,0,pseudo-tested
85,FDFField_getRichText,4,4,2,2,2,0,well-tested
86,FDFField_getSetFieldFlags,4,4,2,2,2,0,well-tested
87,FDFField_getSetWidgetFieldFlags,4,4,2,2,2,0,well-tested
88,FDFField_getWidgetFieldFlags,4,4,2,2,2,0,well-tested
89,PDAnnotation_getAnnotationFlags,4,4,2,2,2,0,well-tested
90,PDCIDFont_getBaseFont,4,4,4,4,4,0,well-tested
91,PDTerminalField_getFieldFlags,4,4,4,4,4,0,well-tested
92,PDType3Font_getCharProc,4,4,4,4,4,0,pseudo-tested
93,PDType3Font_getCharProcs,4,4,4,4,0,4,well-tested
94,PDDeviceCMYK_getDefaultDecode,3,3,2,2,2,0,well-tested
95,FDFDictionary_getFile,2,2,1,1,1,0,pseudo-tested
96,FDFDictionary_getID,2,2,1,1,1,0,pseudo-tested
97,PDCIDFontType0_getWidthFromFont,2,2,1,1,1,0,well-tested
98,PDCIDSystemInfo_getSupplement,2,2,1,1,1,0,well-tested
99,PDExtendedGraphicsState_getTransfer,2,2,1,1,1,0,well-tested
100,PDOutlineItem_getAction,2,2,1,1,1,0,pseudo-tested
101,PDType1Font_getAverageFontWidth,2,2,2,2,2,0,well-tested
102,PDType3Font_getName,2,2,1,1,1,0,well-tested
103,PDViewerPreferences_centerWindow,2,2,1,1,1,0,well-tested
104,PDViewerPreferences_displayDocTitle,2,2,1,1,1,0,well-tested
105,PDViewerPreferences_fitWindow,2,2,1,1,1,0,well-tested
106,PDViewerPreferences_hideMenubar,2,2,1,1,1,0,well-tested
107,PDViewerPreferences_hideToolbar,2,2,1,1,1,0,well-tested
108,PDViewerPreferences_hideWindowUI,2,2,1,1,1,0,well-tested
109,LayerUtility_importPageAsForm_PDDocument_int,1,1,1,1,0,1,pseudo-tested
110,LayerUtility_importPageAsForm_PDDocument_PDPage,1,1,1,1,0,1,pseudo-tested
111,PDAppearanceCharacteristicsDictionary_getRotation,1,1,1,1,1,0,well-tested
*,TOTAL,852329,121691,18291,18291,17655,636,well-tested : 66 pseudo-tested : 45
